w
w																				w
wp																						w
wc																						w
w	c																					w
w		c																				w
w			c																			w
w				c																	x	w
w					c																c	w
w						c														c		w
w							c												c			w
w								c										c				w
w									c								c					w
w										c						c						w
w											c				c							w
w												c		c								w
w		e			e			e					c									w
ggggggggggggggggggggggggggggggggggggggggggggggggggggggggggggggggggggggggggggggggggggggggggg